NO ./images/bruh.xpm
SO ./images/bruh.xpm
WE ./images/bruh.xpm

EA ./images/bruh.xpm


F 255,255,255
C 0,0,0



111111111111111111111111111111111
100000000011000000000000100000001
100000000000000000000000000000001
100100000000000000000000100000001
110000000000000000000000000000001
100000000000000000000000000000011
110000000000000000000N00000000001
111100000000000000000000000000001
110000001101010111000000100010001
100000000000000011000000100010001
100000000000000011010100100010011
110000011101010111110111100011101
111101110111010101011110100010001
111111111111111111111111111111111