NO ./sprites/north.xpm
SO ./sprites/south.xpm
WE ./sprites/west.xpm
EA ./sprites/east.xpm

F 0,0,0
C 84,71,35

        1111111111111111111111111
        1011000000000010000000001
        1000000000000010000000001
        100100S000000000000000001
111111111011000000000010000000001
100000000011000000000011111111111
11110111111100000000000000001
11110111111111011100000000001
11000000110101011101000010001
10000000000000001100000010001
10000000000000001101010010001
110000011101010111110111100111
11110111 1110101 101111010001
11111111 1111111 111111111111