NO ./images/east.xpm
SO ./images/north.xpm
WE ./images/west.xpm
EA ./images/south.xpm

F 220,100,0
C 225,30,0

1111111111111111111111111111111111111111
1000000000000000000000000000000000000001
1000000000000000000000000000000001111111
1000000111110000000000000000000000000001
1000000111110000000000000000000000000001
1000000111110000000000000000000000000001
1000000000000000011111100000000000000001
1000000000000000000000000000000000000001
1000000000000000000000000000000000000001
1000000000000111110000000000000000111111
1000000000000111110000000000000000000001
1000000000000111110000000000000000000001
1000000000000000000000000000000000000001
1000000000000000000000000000000010N00001
1000000000011111111000000000000010000001
1000000000000000000000000000000010000001
1000000000000000000000000000000000000001
1000000000000000000000000000000111111001
1000000000000000000000000000000000000001
1111111111111111111111111111111111111111