NO ./images/east.xpm
SO ./images/north.xpm
WE ./images/west.xpm
EA ./images/south.xpm

F 220,100,0
C 225,30,0

11111111111111111111111111111111111111111111111111111
10000000000000000000000000000000000000000000000000001
10000000000000000000000000000000011111100000000000001
10000001111100000000000000000000000000000000000000001
10000001111100000000000000000000000000000000000000001
10000001111100000000000000000000000000000000000001101
10000000000000000111111000000000000000000000000000101
10000000000000000000000000000000000000000000000000101
10000000000000000000000000000000000000000000000000101
10000000000001111100000000000000001111110000000000101
10000000000001111100000000000000000000000000000000101
10000000000001111100000000000000000000000000000000101
10000000000000000000000000000000000000000000000000001
1000000000000000000000000000000010N000000000000000001
10000000000111111110000000000000100000000000000000001
10000000000000000000000000000000100000000000000000001
10000000000000000000000000000000000000000000000000001
10000000000000000000000000000001111110000000000000001
10000000000000000000000000000000000000000000000000001
11111111111111111111111111111111111111111111111111111