NO ./sprites/north.xpm
SO ./sprites/south.xpm
WE ./sprites/west.xpm
EA ./sprites/east.xpm

F 0,0,0
C 0,0,0

        1111111111111111111111111
        1000000000110000000000001
        1011000001110000000000W01
        1001000000D00000000000001
111111111011000001110000000000001
10000000001100000111111111D111111
11110111111111D11100000010001
11110111111111011101010010001
11000000110101011100000010001
10000000000000001100000000001
10000000000000001101010010001
110000011101010111110111100111
11110111 1110101 101111010001
11111111 1111111 111111111111